+-----------------------------------------------------+
|P.........................========........||.........|
|.................................|........||.........|
|====.....=======.................|........||.........|
|...............|.................|===....====....====|
|...............|=====............|...................|
|...............|...........======|...................|
|====...........|.................|...................|
|..........======.................=======.......======|
|.....................................................|
|.....................................................|
|.................................==..................|
+-----------------------------------------------------+